cristiano	NP	Cristiano
ronaldo	NP	Ronaldo
stepped	VVD	step
help	NN	help
dogs	NNS	dog
housed	VVD	house
shelter	NN	shelter
facing	VVG	face
financial	JJ	financial
difficulties	NNS	difficulty
according	VVG	accord
reports	NNS	report
home	NN	home
country	NN	country
portugal	JJ	portugal
real	JJ	real
madrid	NN	madrid
forward	RB	forward
turned	VVD	turn
last	JJ	last
week	NN	week
often	RB	often
praised	VVD	praise
charity	NN	charity
work	NN	work
topping	VVG	top
list	NN	list
world	NN	world
generous	JJ	generous
athletes	NNS	athlete
ronaldo	NNS	ronaldo
latest	JJS	late
act	NN	act
kindness	NN	kindness
came	VVD	come
response	NN	response
request	NN	request
cantinho	NN	cantinho
lili	NN	lili
dog	NN	dog
rescue	NN	rescue
centre	NN	centre
based	VVN	base
gouveia	NN	gouveia
struggled	VVD	struggle
meet	VV	meet
veterinary	JJ	veterinary
bills	NNS	bill
volunteer	NN	volunteer
centre	NN	centre
contacted	VVD	contact
friend	NN	friend
ronaldo	NP	Ronaldo
family	NN	family
portugal	NN	portugal
international	JJ	international
sent	VVN	send
autographed	JJ	autographed
shirt	NN	shirt
centre	NN	centre
auctioned	VVD	auction
raise	VV	raise
vital	JJ	vital
funds	NNS	fund
want	VVP	want
thank	VV	thank
ronaldo	NP	Ronaldo
bottom	NN	bottom
heart	NN	heart
simple	JJ	simple
gesture	NN	gesture
important	JJ	important
liliana	NN	liliana
santos	NNS	santos
one	CD	one
workers	NNS	worker
dog	NN	dog
shelter	NN	shelter
told	VVD	tell
correrio	NN	correrio
mahna	NN	mahna
shirt	NN	shirt
sent	VVD	send
shelter	NN	shelter
last	JJ	last
november	NN	November
received	VVD	receive
week	NN	week
due	JJ	due
difficulties	NNS	difficulty
delivery	NN	delivery
important	JJ	important
thing	NN	thing
already	RB	already
still	RB	still
believe	VV	believe
said	VVN	say
gloria	NN	gloria
carvalho	NN	carvalho
volunteer	NN	volunteer
initiated	VVD	initiate
contact	NN	contact
ronaldo	NP	Ronaldo
family	NN	family
tail	NN	tail
end	NN	end
last	JJ	last
year	NN	year
ronaldo	NNS	ronaldo
sent	VVD	send
video	JJ	video
message	NN	message
via	IN	via
instagram	NN	instagram
account	NN	account
children	NNS	child
syria	NN	syria
affected	VVD	affect
county	NN	county
long	RB	long
running	VVG	run
civil	JJ	civil
war	NN	war
telling	VVG	tell
true	JJ	true
heroes	NNS	hero
former	JJ	former
manchester	NN	manchester
united	VVN	unite
forward	RB	forward
also	RB	also
made	VVN	make
generous	JJ	generous
donation	NN	donation
save	IN	save
children	NNS	child
international	JJ	international
non	JJ	non
governmental	JJ	governmental
organisation	NN	organisation
works	VVZ	work
ambassador	NN	ambassador