year	NN	year
old	JJ	old
mechanical	JJ	mechanical
computer	NN	computer
salvaged	VVN	salvage
roman	JJ	roman
shipwreck	NN	shipwreck
astounded	VVD	astound
scientists	NNS	scientist
finally	RB	finally
unravelled	VVN	unravel
secrets	NNS	secret
sophisticated	JJ	sophisticated
device	NN	device
works	NNS	work
machine	NN	machine
lost	VVD	lose
among	IN	among
cargo	NN	cargo
ship	NN	ship
carrying	NN	carrying
sank	VVD	sink
water	NN	water
coast	NN	coast
greek	NN	Greek
island	NN	island
antikythera	NN	antikythera
chance	NN	chance
sponge	NN	sponge
diver	NN	diver
called	VVD	call
elias	NNS	elias
stadiatos	NNS	stadiatos
discovered	VVD	discover
wreck	NN	wreck
recovered	VVD	recover
statues	NNS	statue
artifacts	NNS	artifact
site	NN	site
machine	NN	machine
first	RB	first
came	VVD	come
light	JJ	light
archaeologist	NN	archaeologist
working	VVG	work
recovered	VVN	recover
objects	NNS	object
noticed	VVD	notice
lump	NN	lump
rock	NN	rock
gear	NN	gear
wheel	NN	wheel
embedded	VVD	embed
closer	JJR	close
inspection	NN	inspection
material	NN	material
brought	VVD	bring
stricken	JJ	stricken
ship	NN	ship
subsequently	RB	subsequently
revealed	VVN	reveal
pieces	NNS	piece
gear	VVP	gear
wheels	NNS	wheel
dials	NNS	dial
clock	NN	clock
like	IN	like
hands	NNS	hand
wooden	JJ	wooden
bronze	NN	bronze
casing	NN	casing
bearing	VVG	bear
ancient	JJ	ancient
greek	NN	Greek
inscriptions	NNS	inscription
since	IN	since
discovery	NN	discovery
scientists	NNS	scientist
trying	VVG	try
reconstruct	VV	reconstruct
device	NN	device
known	VVN	know
astronomical	JJ	astronomical
calendar	NN	calendar
capable	JJ	capable
tracking	NN	tracking
remarkable	JJ	remarkable
precision	NN	precision
position	NN	position
sun	NN	sun
several	JJ	several
heavenly	JJ	heavenly
bodies	NNS	body
phases	VVZ	phase
moon	NN	moon
experts	NNS	expert
believe	VVP	believe
earliest	RBS	earliest
known	VVN	know
device	NN	device
use	NN	use
gear	NN	gear
wheels	NNS	wheel
far	RB	far
sophisticated	JJ	sophisticated
object	NN	object
found	VVD	find
ancient	JJ	ancient
medieval	JJ	medieval
periods	NNS	period
using	VVG	use
modern	JJ	modern
computer	NN	computer
ray	NN	ray
tomography	NN	tomography
high	JJ	high
resolution	NN	resolution
surface	NN	surface
scanning	VVG	scan
team	NN	team
led	VVD	lead
mike	NN	mike
edmunds	NNS	edmunds
tony	JJ	tony
freeth	NN	freeth
cardiff	NN	cardiff
university	NN	university
peered	VVN	peer
inside	IN	inside
fragments	NNS	fragment
crust	NN	crust
encased	VVD	encase
mechanism	NN	mechanism
read	VVD	read
faintest	JJS	faint
inscriptions	NNS	inscription
covered	VVD	cover
outer	JJ	outer
casing	NN	casing
machine	NN	machine
detailed	JJ	detailed
imaging	NN	imaging
mechanism	NN	mechanism
suggests	VVZ	suggest
dates	NNS	date
back	RB	back
gear	VVP	gear
wheels	NNS	wheel
enabling	VVG	enable
follow	NN	follow
movements	NNS	movement
moon	NN	moon
sun	NN	sun
zodiac	NN	zodiac
predict	VVP	predict
eclipses	NNS	eclipse
even	RB	even
recreate	VVP	recreate
irregular	JJ	irregular
orbit	NN	orbit
moon	NN	moon
motion	NN	motion
known	VVN	know
first	JJ	first
lunar	JJ	lunar
anomaly	NN	anomaly
developed	VVD	develop
astronomer	NN	astronomer
hipparcus	NN	hipparcus
rhodes	NNS	rhodes
century	NN	century
may	MD	may
consulted	VVN	consult
machine	NN	machine
construction	NN	construction
scientists	NNS	scientist
speculate	VVP	speculate
remarkably	RB	remarkably
scans	VVZ	scan
showed	VVN	show
device	NN	device
uses	VVZ	use
differential	JJ	differential
gear	NN	gear
previously	RB	previously
believed	VVD	believe
invented	VVN	invent
century	NN	century
level	NN	level
miniaturisation	NN	miniaturisation
complexity	NN	complexity
parts	NNS	part
comparable	JJ	comparable
century	NN	century
clocks	NNS	clock
researchers	NNS	researcher
believe	VVP	believe
machine	NN	machine
known	VVN	know
antikythera	NP	antikythera
mechanism	NN	mechanism
may	MD	may
among	IN	among
treasure	NN	treasure
looted	VVD	loot
rhodes	NNS	rhodes
route	NN	route
rome	NN	rome
celebration	NN	celebration
staged	VVD	stage
julius	NN	julius
caesar	NP	Caesar
one	CD	one
remaining	VVG	remain
mysteries	NNS	mystery
greek	NN	Greek
technology	NN	technology
invented	VVD	invent
machine	NN	machine
seemed	VVD	seem
disappear	VV	disappear
civilisation	NN	civilisation
believed	VVD	believe
created	VVN	create
anything	NN	anything
complex	NN	complex
another	DT	another
years	NNS	year
one	CD	one
explanation	NN	explanation
could	MD	could
bronze	VV	bronze
often	RB	often
recycled	JJ	recycled
period	NN	period
device	NN	device
made	VVD	make
many	JJ	many
artefacts	NNS	artefact
time	NN	time
long	RB	long
ago	RB	ago
melted	VVD	melt
erased	VVN	erase
archaelogical	JJ	archaelogical
record	NN	record
fateful	JJ	fateful
sinking	VVG	sink
ship	NN	ship
carrying	VVG	carry
antikythera	NN	antikythera
mechanism	NN	mechanism
may	MD	may
inadvertently	RB	inadvertently
preserved	VVN	preserve
device	NN	device
extraordinary	JJ	extraordinary
thing	NN	thing
kind	NN	kind
said	VVD	say
professor	NN	professor
edmunds	NNS	edmunds
astronomy	NN	astronomy
exactly	RB	exactly
right	JJ	right
terms	NNS	term
historic	JJ	historic
scarcity	NN	scarcity
value	NN	value
regard	NN	regard
mechanism	NN	mechanism
valuable	JJ	valuable
mona	NN	mona
lisa	NN	lisa
research	NN	research
appears	VVZ	appear
journal	NN	journal
nature	NN	nature
today	NN	today
carried	VVD	carry
scientists	NNS	scientist
national	JJ	national
archaeological	JJ	archaeological
museum	NN	museum
athens	NNS	athens
mechanism	NN	mechanism
held	VVD	hold
universities	NNS	university
athens	NNS	athens
thessaloniki	NNS	thessaloniki