colombia	NN	colombia
business	NN	business
asked	VVD	ask
diversify	VV	diversify
coffee	NN	coffee
colombia	NN	colombia
government	NN	government
trade	NN	trade
official	NN	official
urged	VVD	urge
business	NN	business
community	NN	community
aggressively	RB	aggressively
diversify	VV	diversify
activities	NNS	activity
stop	VV	stop
relying	VVG	rely
heavily	RB	heavily
coffee	NN	coffee
samuel	NN	samuel
alberto	NN	alberto
yohai	NN	yohai
director	NN	director
foreign	JJ	foreign
trade	NN	trade
institute	NN	institute
incomex	NN	incomex
said	VVD	say
private	JJ	private
businessmen	NNS	businessman
become	VVP	become
called	VVN	call
mental	JJ	mental
hostages	NNS	hostage
coffee	NN	coffee
traditionally	RB	traditionally
colombia	NN	colombia
major	JJ	major
export	NN	export
national	JJ	national
planning	NN	planning
department	NN	department
forecast	NN	forecast
coffee	NN	coffee
account	VVP	account
one	CD	one
third	JJ	third
total	NN	total
exports	VVZ	export
billion	CD	billion
dlrs	NN	dlrs
oil	NN	oil
energy	NN	energy
products	NNS	product
making	VVG	make
another	DT	another
third	JJ	third
non	JJ	non
traditional	JJ	traditional
exports	NNS	export
remainder	NN	remainder