commission	NN	commission
details	NNS	detail
sugar	NN	sugar
tender	NN	tender
commission	NN	commission
confirmed	VVD	confirm
granted	JJ	granted
export	NN	export
licences	VVZ	licence
tonnes	NNS	tonne
current	JJ	current
series	NN	series
white	JJ	white
sugar	NN	sugar
maximum	NN	maximum
export	NN	export
rebate	NN	rebate
european	JJ	European
currency	NN	currency
units	NNS	unit
ecus	NN	ecus
per	IN	per
kilos	NNS	kilo
traders	NNS	trader
france	NN	france
received	VVD	receive
tonnes	NNS	tonne
west	IN	west
germany	NN	germany
belgium	NN	Belgium
spain	NN	spain
denmark	NN	denmark
tonnes	NNS	tonne