mild	JJ	mild
coffee	NN	coffee
growers	NNS	grower
meet	VVP	meet
guatemala	NN	guatemala
large	JJ	large
group	NN	group
milds	NNS	mild
coffee	NN	coffee
growing	VVG	grow
nations	NNS	nation
hold	VV	hold
talks	NNS	talk
guatemala	NN	guatemala
next	JJ	next
month	NN	month
map	NN	map
strategy	NN	strategy
next	JJ	next
september	NN	September
meeting	NN	meeting
international	JJ	international
coffee	NN	coffee
organisation	NN	organisation
ico	NN	ico
mario	NP	Mario
fernandez	NP	Fernandez
executive	JJ	executive
director	NN	director
costa	NN	costa
rican	NN	rican
coffee	NN	coffee
institute	NN	institute
said	VVD	say
delegates	NNS	delegate
mexico	NN	mexico
dominican	NN	Dominican
republic	NN	republic
peru	NN	Peru
ecuador	NN	ecuador
india	NN	india
papua	NN	papua
new	JJ	new
guinea	NN	guinea
five	CD	five
central	JJ	central
american	NN	American
nations	NNS	nation
participate	VVP	participate
two	CD	two
day	NN	day
strategy	NN	strategy
session	NN	session
beginning	NN	beginning
may	MD	may
main	JJ	main
topic	NN	topic
reform	NN	reform
many	JJ	many
producing	VVG	produce
countries	NNS	country
perceive	VVP	perceive
ico	NN	ico
unfair	JJ	unfair
distribution	NN	distribution
export	NN	export
quotas	NNS	quota
fernandez	NN	fernandez
said	VVD	say
said	VVD	say
costa	NN	costa
rica	NN	rica
would	MD	would
press	VV	press
quotas	NNS	quota
based	VVN	base
real	JJ	real
production	NN	production
export	NN	export
potential	JJ	potential
country	NN	country
past	NN	past
years	NNS	year
distribute	VVP	distribute
quotas	NNS	quota
based	VVN	base
historic	JJ	historic
production	NN	production
levels	NNS	level
rather	RB	rather
recent	JJ	recent
harvests	NNS	harvest
crop	NN	crop
estimates	NNS	estimate