coffee	NN	coffee
could	MD	could
drop	VV	drop
cts	NN	cts
cardenas	NNS	cardenas
says	VVZ	say
international	JJ	international
coffee	NN	coffee
prices	NNS	price
could	MD	could
drop	VV	drop
cents	NNS	cent
next	JJ	next
october	NN	October
agreement	NN	agreement
reached	VVD	reach
support	NN	support
market	NN	market
jorge	NN	jorge
cardenas	NNS	cardenas
manager	NN	manager
colombia	NN	colombia
national	JJ	national
coffee	NN	coffee
growers	NNS	grower
federation	NN	federation
said	VVD	say
speaking	VVG	speak
forum	NN	forum
industrialists	NNS	industrialist
said	VVD	say
one	CD	one
reasons	NNS	reason
market	NN	market
already	RB	already
saturated	VVN	saturate
producers	NNS	producer
excess	JJ	excess
production	NN	production
stockpiles	NNS	stockpile
mln	NN	mln
bags	NNS	bag
today	NN	today
may	MD	may
futures	NNS	future
new	JJ	new
york	VVP	york
settled	JJ	settled
cents	NNS	cent