sugar	NN	sugar
tender	NN	tender
hard	RB	hard
predict	VVP	predict
london	NN	london
trade	NN	trade
outcome	NN	outcome
today	NN	today
european	JJ	European
community	NN	community
white	JJ	white
sugar	NN	sugar
tender	NN	tender
extremely	RB	extremely
difficult	JJ	difficult
predict	VVP	predict
last	JJ	last
week	NN	week
substantial	JJ	substantial
award	NN	award
tonnes	NNS	tonne
highest	RBS	highest
ever	RB	ever
rebate	VV	rebate
european	JJ	European
currency	NN	currency
units	NNS	unit
ecus	NN	ecus
per	IN	per
kilos	NNS	kilo
traders	NNS	trader
said	VVD	say
said	VVD	say
believed	VVN	believe
tonnage	NN	tonnage
would	MD	would
probably	RB	probably
smaller	JJR	small
around	IN	around
tonnes	NNS	tonne
declined	VVD	decline
give	VV	give
view	NN	view
likely	JJ	likely
restitution	NN	restitution
last	JJ	last
week	NN	week
european	NN	European
commission	NN	commission
accepted	VVD	accept
tonnes	NNS	tonne
sugar	NN	sugar
intervention	NN	intervention
operators	NNS	operator
protesting	VVG	protest
low	JJ	low
rebates	NNS	rebate
might	NN	might
determining	VVG	determine
factor	NN	factor
today	NN	today
result	NN	result
added	VVD	add