barcelona	NN	barcelona
president	NN	president
josep	NN	josep
maria	NNS	mare
bartomeu	NN	bartomeu
admitted	VVD	admit
club	NN	club
would	MD	would
discuss	VV	discuss
possibility	NN	possibility
leaving	VVG	leave
liga	NN	liga
catalonia	NNS	catalonia
gained	VVD	gain
independence	NN	independence
spain	NN	spain
violence	NN	violence
catalonia	NN	catalonia
weekend	NN	weekend
police	NN	police
voters	NNS	voter
clashed	VVD	clash
referendum	NN	referendum
deemed	VVD	deem
illegal	JJ	illegal
central	JJ	central
government	NN	government
leading	VVG	lead
barcelona	NN	barcelona
take	VV	take
decision	NN	decision
play	NN	play
game	NN	game
las	NNS	la
palmas	NNS	palmas
sunday	NN	Sunday
night	NN	night
behind	IN	behind
closed	JJ	closed
doors	NNS	door
catalan	NN	Catalan
sports	NNS	sport
minister	NN	minister
already	RB	already
said	VVD	say
teams	NNS	team
like	IN	like
barcelona	NN	barcelona
espanyol	NN	espanyol
would	MD	would
eligible	JJ	eligible
play	NN	play
england	NN	england
france	NN	france
italy	RB	italy
well	RB	well
spain	VV	spain
used	VVN	use
teams	NNS	team
like	IN	like
monaco	NN	monaco
swansea	NN	swansea
examples	NNS	example
uefa	NN	uefa
allowing	VVG	allow
bartomeu	NN	bartomeu
corroborated	VVD	corroborate
admitting	VVG	admit
would	MD	would
need	VV	need
talked	VVN	talk
region	NN	region
achieve	VV	achieve
independence	NN	independence
situation	NN	situation
exist	VVP	exist
far	RB	far
said	VVN	say
monday	NN	Monday
regards	VVZ	regard
things	NNS	thing
happen	VV	happen
future	JJ	future
something	NN	something
board	NN	board
directors	NNS	director
would	MD	would
discuss	VV	discuss
would	MD	would
something	RB	something
analyse	VV	analyse
calmly	RB	calmly
discuss	VV	discuss
subject	JJ	subject
intensely	RB	intensely
obviously	RB	obviously
find	VV	find
best	JJS	good
solution	NN	solution
independence	NN	independence
happens	VVZ	happen
board	NN	board
directors	NNS	director
see	VVP	see