french	JJ	French
aid	NN	aid
togo	NN	togo
help	NN	help
coffee	NN	coffee
cocoa	NN	cocoa
trees	NNS	tree
france	NN	france
provide	VVP	provide
togo	NN	togo
mln	NN	mln
cfa	NN	cfa
francs	NNS	franc
aid	NN	aid
range	NN	range
projects	NNS	project
include	VVP	include
development	NN	development
coffee	NN	coffee
cocoa	NN	cocoa
industries	NNS	industry
reafforestation	NN	reafforestation
south	NN	south
country	NN	country
official	NN	official
sources	NNS	source
said	VVD	say