cargill	NP	Cargill
confirms	VVZ	confirm
white	JJ	white
sugar	NN	sugar
sale	NN	sale
india	NN	india
london	NN	london
based	VVN	base
trader	NN	trader
cargill	NN	cargill
ltd	NNS	ltd
confirmed	VVD	confirm
sold	VVN	sell
one	CD	one
cargo	NN	cargo
white	JJ	white
sugar	NN	sugar
india	NN	india
shipment	NN	shipment
april	NN	April
may	MD	may
yesterday	RB	yesterday
tender	VV	tender
price	NN	price
details	NNS	detail
immediately	RB	immediately
available	JJ	available
traders	NNS	trader
suggested	VVD	suggest
business	NN	business
done	VVN	do
around	IN	around
dlrs	JJ	dlrs
tonne	NN	tonne
cif	NN	cif
india	NN	india
tendered	VVD	tender
one	CD	one
two	CD	two
cargoes	NNS	cargo
white	JJ	white
sugar	NN	sugar
specific	JJ	specific
requirement	NN	requirement
shipping	NN	shipping
period	NN	period