one	CD	one
quietly	RB	quietly
unsettling	JJ	unsettling
findings	NNS	finding
psychology	NN	psychology
money	NN	money
verbal	JJ	verbal
overshadowing	VVG	overshadow
weird	JJ	weird
fact	NN	fact
memory	NN	memory
liable	JJ	liable
make	NN	make
wonder	NN	wonder
anything	NN	anything
believe	VVP	believe
life	NN	life
really	RB	really
true	JJ	true
finding	NN	finding
putting	VVG	put
experiences	NNS	experience
words	NNS	word
talking	VVG	talk
others	NNS	other
writing	NN	writing
makes	VVZ	make
less	RBR	less
likely	RB	likely
recall	VV	recall
accurately	RB	accurately
witness	NN	witness
mugging	VVG	mug
say	NN	say
scribble	NN	scribble
record	NN	record
seen	VVN	see
prone	JJ	prone
misremember	NN	misremember
written	VVN	write
nothing	NN	nothing
think	VVP	think
times	NNS	time
told	VVD	tell
friends	NNS	friend
ridiculous	JJ	ridiculous
thing	NN	thing
boss	NN	boss
said	VVD	say
felt	NN	felt
heard	VVD	hear
presidential	JJ	presidential
election	NN	election
result	NN	result
like	IN	like
went	VVD	go
labour	NN	labour
likelihood	NN	likelihood
none	NN	none
conversations	NNS	conversation
fixed	VVN	fix
experience	VVP	experience
vividly	RB	vividly
memory	NN	memory
probably	RB	probably
distorted	VVN	distort
recollections	NNS	recollection
may	MD	may
bear	VV	bear
little	JJ	little
resemblance	NN	resemblance
truth	NN	truth
consequences	NNS	consequence
far	RB	far
graver	JJR	grave
accuracy	NN	accuracy
anecdotes	NNS	anecdote
elizabeth	NN	elizabeth
loftus	NN	loftus
leading	VVG	lead
researcher	NN	researcher
verbal	JJ	verbal
overshadowing	VVG	overshadow
advocates	NNS	advocate
wrongly	RB	wrongly
convicted	VVN	convict
result	NN	result
horrible	JJ	horrible
irony	NN	irony
trials	NNS	trial
need	VVP	need
eyewitnesses	NNS	eyewitness
give	VV	give
statements	NNS	statement
yet	RB	yet
act	VVP	act
giving	VVG	give
statement	NN	statement
undermines	VVZ	undermine
value	NN	value
eyewitness	NN	eyewitness
closer	JJR	close
inspection	NN	inspection
psychological	JJ	psychological
oddity	NN	oddity
starts	NNS	start
look	VVP	look
less	RBR	less
strange	JJ	strange
language	NN	language
linguist	NN	linguist
nick	NN	nick
enfield	NN	enfield
points	NNS	point
pretty	RB	pretty
much	RB	much
exists	VVZ	exist
order	NN	order
categorise	VV	categorise
things	NNS	thing
sift	VV	sift
chaos	NN	chaos
reality	NN	reality
pigeonholes	NNS	pigeonhole
provided	VVD	provide
pre	NN	pre
agreed	VVD	agree
words	NNS	word
chose	VVD	choose
verbal	JJ	verbal
overshadowing	VVG	overshadow
answer	NN	answer
edge	NN	edge
website	NN	website
annual	JJ	annual
question	NN	question
year	NN	year
scientific	JJ	scientific
term	NN	term
concept	NN	concept
ought	MD	ought
widely	RB	widely
known	VVN	know
putting	VVG	put
something	NN	something
pigeonhole	NN	pigeonhole
means	VVZ	mean
putting	VVG	put
others	NNS	other
definition	NN	definition
describe	VVP	describe
someone	NN	someone
three	CD	three
dogs	VVZ	dog
focus	NN	focus
animals	NNS	animal
share	NN	share
dogs	VVZ	dog
disregard	NN	disregard
fact	NN	fact
great	JJ	great
dane	NN	Dane
sheepdog	NN	sheepdog
yorkshire	NP	Yorkshire
terrier	NN	terrier
old	JJ	old
young	JJ	young
excitable	JJ	excitable
placid	JJ	placid
research	NN	research
verbal	JJ	verbal
overshadowing	VVG	overshadow
enfield	NN	enfield
writes	VVZ	write
suggests	VVZ	suggest
pigeonholing	VVG	pigeonhole
overwrites	VVZ	overwrite
previous	JJ	previous
memory	NN	memory
words	NNS	word
render	VVP	render
experience	NN	experience
specific	JJ	specific
information	NN	information
left	VVD	leave
deleted	VVN	delete
even	RB	even
best	JJS	good
writer	NN	writer
must	MD	must
unavoidably	RB	unavoidably
misrepresent	VV	misrepresent
world	NN	world
communicate	VVP	communicate
otherwise	RB	otherwise
work	VV	work
loftus	NN	loftus
others	NNS	other
seems	VVZ	seem
show	NN	show
misrepresentation	NN	misrepresentation
permanent	JJ	permanent
yet	CC	yet
annoying	VVG	annoy
feature	NN	feature
brains	NNS	brain
surely	RB	surely
flipside	VVP	flipside
extremely	RB	extremely
useful	JJ	useful
one	CD	one
way	NN	way
verbalising	VVG	verbalise
problems	NNS	problem
keeping	VVG	keep
journal	NN	journal
talking	VVG	talk
renders	NNS	render
manageable	JJ	manageable
whether	IN	whether
come	VVN	come
solutions	NNS	solution
share	NN	share
written	VVN	write
put	JJ	put
worries	NNS	worry
words	NNS	word
categorise	VVP	categorise
thus	RB	thus
get	VV	get
control	NN	control
fact	NN	fact
express	RB	express
means	VVZ	mean
entirely	RB	entirely
got	VV	got
better	RBR	well
never	RB	never
managed	VVD	manage
keep	VV	keep
diary	NN	diary
sense	NN	sense
record	NN	record
events	NNS	event
verbal	JJ	verbal
overshadowing	VVG	overshadow
implies	VVZ	imply
would	MD	would
warp	VV	warp
memories	NNS	memory
anyway	RB	anyway
journal	NN	journal
hand	NN	hand
harnesses	VVZ	harness
effect	NN	effect
works	NNS	work
transforms	VVZ	transform
material	NN	material
words	NNS	word
change	VVP	change
things	NNS	thing
thereby	RB	thereby