thailand	NN	thailand
renew	VV	renew
long	JJ	long
term	NN	term
sugar	NN	sugar
contracts	NNS	contract
trade	NN	trade
thailand	NN	thailand
negotiate	VV	negotiate
tomorrow	NN	tomorrow
selected	JJ	selected
trade	NN	trade
houses	NNS	house
renewal	NN	renewal
long	JJ	long
term	NN	term
raw	JJ	raw
sugar	NN	sugar
sales	NNS	sale
contracts	NNS	contract
cover	VVP	cover
next	JJ	next
five	CD	five
years	NNS	year
rate	NN	rate
tonnes	NNS	tonne
annually	RB	annually
traders	NNS	trader
said	VVD	say
also	RB	also
reported	VVN	report
vague	JJ	vague
talk	NN	talk
algeria	NNS	algeria
may	MD	may
seeking	VVG	seek
tonnes	NNS	tonne
raws	NNS	raw
tomorrow	NN	tomorrow
details	NNS	detail
unclear	JJ	unclear